1111111111111111111111111111111111
1P00001000000000000C00100000000001
1010111111111110111111111101111101
1010000000000010000000000100000101
1011111111101111110111111111111101
1000000000100000000100000000000001
1111011101111111110111111110111111
10000001000000000000000000000000E1
1111111111111111111111111111111111
