1111111111111111111111111111111111111111111111111111
1P000000000000000000C0000000000000000000000000000001
1011111111111111111111111111111111111111111111111101
1000000000000000000000000000000000000000000000000101
1011111111111111111111111111111111111111111111110101
100000000000000000000000000C000000000000000000000101
1011111111111111111111111111111111111111111111111101
1000000000000000000000000000000000000000000000000001
1111111111111111111111111111111111111111111111111101
1000000000000000000000000000000000000000000000000I01
1011111111111111111111111111111111111111111111111101
100C000000000000000000000000000000000000000000000001
1011111111111111111111111111111111111111111111111101
1000000000000000000000000000000000000000000000000001
1011111111111111111111111111111111111111111111111101
1I000000000000000000000000000000000000000000000000E1
1011111111111111111111111111111111111111111111111101
1000000000000000000000000000000000000000000000000001
1011111111111111111111111111111111111111111111111101
1111111111111111111111111111111111111111111111111111
