11111111111111111111111111111111111111
1P0000000000000000C0000000000000000001
10111111011111101111101111111111011101
100000010000001000000010000C0001000001
10111101111110101111101111111011111101
100000010000101000000000000000000I0001
11110111101110101111101111111111110101
10000000001000001000001000000000000101
10111111111011111101111101111111110101
10100000000010000000I00000000000000101
10101111111010111111101111111111110101
10I0000000001000000C000000000000000E01
11111111111111111111111111111111111111
