111111111111111111111111111111111111111
1P0000000000000000C000000000000000I0011
101111111111101111111011111111110111101
100000010000001000000010000000010000001
101111010111101011111011111110111111101
100000010000101000000000000000000000001
111101111011101011111011111111111101101
100000000010000010000010000000000001001
101111111110111111011111011111111101101
101000000000100000000000000000000001001
101011111110101111111011111111111101101
1000000000001000000C000000000000000E001
111111111111111111111111111111111111111
